Okręg;Liczba komisji;Liczba uwzględnionych komisji;Kart przekazane do komisji;Uprawnionych do głosowania;Karty nieużyte;Karty wydane osobiście;Karty wydane pocztą;Karty wydane łącznie;Głosujący przez pełnomocnika;Głosujący z zaświadczeniem;Otrzymane koperty;Koperty bez deklaracji;Koperty z niepodpisaną deklaracją;Koperty bez koperty z głosem;Koperty z niezamnkiętą kopertą z głosem;Koperty z głosem dodane do urny;Karty wyjęte z urny;Karty wyjęte z kopert;Nieważne karty;Ważne karty;Nieważne głosy;Zbyt wiele Xów;Brak Xa;Wykreślona lista;Głosów ważnych łącznie;KOALICYJNY KOMITET WYBORCZY KOALICJA OBYWATELSKA PO .N IPL ZIELONI - ZPOW-601-6/19;KOMITET WYBORCZY AKCJA ZAWIEDZIONYCH EMERYTÓW RENCISTÓW - ZPOW-601-21/19;KOMITET WYBORCZY KONFEDERACJA WOLNOŚĆ I NIEPODLEGŁOŚĆ - ZPOW-601-5/19;KOMITET WYBORCZY POLSKIE STRONNICTWO LUDOWE - ZPOW-601-19/19;KOMITET WYBORCZY PRAWICA - ZPOW-601-20/19;KOMITET WYBORCZY PRAWO I SPRAWIEDLIWOŚĆ - ZPOW-601-9/19;KOMITET WYBORCZY SKUTECZNI PIOTRA LIROYA-MARCA - ZPOW-601-17/19;KOMITET WYBORCZY SOJUSZ LEWICY DEMOKRATYCZNEJ - ZPOW-601-1/19;KOMITET WYBORCZY WYBORCÓW KOALICJA BEZPARTYJNI I SAMORZĄDOWCY - ZPOW-601-10/19;KOMITET WYBORCZY WYBORCÓW MNIEJSZOŚĆ NIEMIECKA - ZPOW-601-15/19
1;0;0;697907;757942;259666;438239;37;438276;490;5597;35;6;1;0;0;28;438194;28;84;438110;5674;3655;2019;0;432436;108191;0;25319;31006;0;183364;0;71061;13495;0
2;0;0;470923;514042;183904;287009;44;287053;417;4854;42;2;1;0;0;39;287015;39;37;286978;3976;2688;1288;0;283002;90812;0;15346;20528;0;114728;0;34957;6631;0
3;0;0;895625;1001757;235423;660182;82;660264;630;8921;80;2;0;0;0;78;660117;78;90;660027;5572;3230;2342;0;654455;214629;0;48775;42269;0;226915;0;100843;21024;0
4;0;0;712403;778558;245980;466427;77;466504;480;3538;75;6;0;0;0;69;466407;69;13;466394;6412;4389;2023;0;459982;142844;0;32406;41497;0;167550;0;69763;5922;0
5;0;0;742540;813079;284127;458383;64;458447;575;5302;64;0;0;0;0;64;458408;64;63;458345;6015;3914;2101;0;452330;119526;0;28625;49225;0;182648;0;67076;5230;0
6;0;0;862523;938157;291363;571149;69;571218;952;4939;69;4;0;1;0;64;571138;64;34;571104;5507;3176;2331;0;565597;109185;0;40012;51474;0;313284;0;44152;7490;0
7;0;0;690813;747526;284118;406690;28;406718;782;3251;27;2;0;0;0;25;406678;25;18;406660;5342;3530;1812;0;401318;59401;0;23439;47604;0;238802;0;27404;4668;0
8;0;0;713950;776935;269383;444548;51;444599;465;3003;51;3;0;0;0;48;444492;48;64;444428;6511;4369;2142;0;437917;136955;0;31490;50943;0;150188;0;68341;0;0
9;0;0;566005;612800;147178;418814;83;418897;414;2941;81;2;1;0;0;78;418745;78;106;418639;3099;1632;1467;0;415540;148830;0;27627;18828;0;136731;0;83524;0;0
10;0;0;521078;567583;170181;350868;21;350889;399;1725;20;0;0;0;0;20;350848;20;16;350832;4506;2973;1533;0;346326;54160;0;23427;36151;0;194658;0;37930;0;0
11;0;0;701279;765170;234986;466274;22;466296;531;2206;20;0;0;0;0;20;466190;20;35;466155;5916;3738;2178;0;460239;94268;0;27054;47373;0;229245;0;55116;7183;0
12;0;0;465480;508888;145551;319925;26;319951;402;1780;26;1;0;0;0;25;319928;25;23;319905;3691;2335;1356;0;316214;72869;0;22334;24996;0;169106;0;26909;0;0
13;0;0;862812;953716;208617;654148;133;654281;733;9912;129;2;0;0;0;127;654130;127;152;653978;4691;2379;2312;0;649287;197930;0;51855;47219;1765;256847;0;84457;9214;0
14;0;0;576255;621580;201521;374708;45;374753;465;10724;45;2;0;1;0;42;374703;42;3;374700;4501;2801;1700;0;370199;51183;0;25747;27203;0;243583;0;22483;0;0
15;0;0;533024;580610;181794;351124;31;351155;445;1909;31;0;0;0;0;31;351098;31;23;351075;3987;2481;1506;0;347088;48597;0;24695;46333;0;206845;0;20618;0;0
16;0;0;594543;651882;218513;376018;23;376041;516;1885;21;0;0;0;0;21;376000;21;3;375997;5436;3388;2048;0;370561;62429;0;19405;56227;0;194371;0;32448;5681;0
17;0;0;511886;556858;173078;338801;28;338829;442;1728;26;1;0;0;0;25;338782;25;15;338767;3758;2152;1606;0;335009;57449;0;19724;34185;0;193709;2503;24884;2555;0
18;0;0;684696;752277;225904;458770;25;458795;599;2582;24;1;0;0;0;23;458762;23;10;458752;5846;3347;2499;0;452906;63124;1412;29390;54085;0;270641;0;29235;5019;0
19;0;0;1670076;1742400;279264;1390641;194;1390835;1164;38061;184;21;2;0;0;164;1389970;164;447;1389523;7606;3476;4130;0;1381917;581077;0;103843;65683;0;379880;0;251434;0;0
20;0;0;774331;856128;170104;604224;96;604320;507;5330;95;2;1;0;0;92;604128;92;68;604060;5333;2964;2369;0;598727;171286;0;39675;51484;0;244823;0;78348;13111;0
21;0;0;719838;779536;307303;412525;29;412554;468;2414;29;0;0;0;0;29;412469;29;17;412452;6013;4104;1909;0;406439;108570;0;23176;41901;0;152999;0;47699;0;32094
22;0;0;648912;701642;253336;395573;31;395604;766;6939;31;2;0;0;0;29;395556;29;7;395549;4968;3298;1670;0;390581;62246;0;26615;30655;0;247488;0;23577;0;0
23;0;0;907022;988338;312711;594307;41;594348;850;4375;40;1;0;0;0;39;594277;38;19;594258;5472;3172;2300;0;588786;84703;0;48600;45868;0;367268;3530;38817;0;0
24;0;0;848752;922518;323189;525568;62;525630;895;3680;62;2;1;1;0;58;525560;58;17;525543;4965;2770;2195;0;520578;109527;1775;36207;48566;0;270888;2272;47342;4001;0
25;0;0;753982;831651;219856;534255;99;534354;500;8501;99;4;1;0;0;94;534071;94;46;534025;5196;3218;1978;0;528829;218484;0;38153;31203;0;169753;0;71236;0;0
26;0;0;872627;935164;285392;587272;100;587372;525;7362;99;13;2;0;0;84;587233;84;43;587190;6468;3692;2776;0;580722;208208;0;42364;46132;0;211582;0;72436;0;0
27;0;0;569412;605360;176394;393014;38;393052;503;4575;38;5;0;0;0;33;392959;33;12;392947;3691;2085;1606;0;389256;105876;0;28900;27752;0;182027;0;44701;0;0
28;0;0;431901;470075;144067;287824;42;287866;330;1864;40;0;0;0;0;40;287791;40;14;287777;3260;2141;1119;0;284517;64374;0;17278;24704;0;125990;0;44354;7817;0
29;0;0;534418;581805;190114;344301;30;344331;334;1759;29;1;0;0;0;28;344292;28;8;344284;3637;2074;1563;0;340647;111078;0;26114;20408;0;128579;0;45583;8885;0
30;0;0;524127;558077;186917;337185;27;337212;353;1107;27;1;0;0;0;26;337148;26;18;337130;3294;1901;1393;0;333836;92493;0;23939;18816;0;161160;0;32300;5128;0
31;0;0;677792;740858;203558;474223;52;474275;482;2886;51;2;1;0;1;47;474144;47;21;474123;4490;2516;1974;0;469633;174683;0;34416;20512;0;184030;0;55992;0;0
32;0;0;491534;537371;153020;338510;42;338552;355;1516;41;2;1;0;1;37;338481;37;7;338474;3043;1874;1169;0;335431;99499;0;21650;16263;0;124553;0;73466;0;0
33;0;0;927566;998797;351202;576353;33;576386;899;4587;32;0;0;1;0;31;576308;31;32;576276;6385;4016;2369;0;569891;94880;0;33895;56289;0;314455;8273;56699;5400;0
34;0;0;447186;484489;191809;255374;20;255394;264;1772;20;2;1;1;0;16;255370;16;11;255359;4540;3263;1277;0;250819;71320;0;14187;27319;0;102478;0;29196;6319;0
35;0;0;569496;619669;232809;336643;33;336676;393;3804;32;4;0;0;1;27;336647;27;12;336635;4951;3096;1855;0;331684;87780;0;23134;43758;0;128760;2340;45912;0;0
36;0;0;720895;782102;254203;466690;56;466746;388;1897;56;2;1;1;0;52;466669;52;8;466661;7509;5005;2504;0;459152;113489;0;30177;58759;0;195053;0;61674;0;0
37;0;0;556500;606633;198030;358457;33;358490;312;1504;31;2;0;0;0;29;358437;29;21;358416;5375;3773;1602;0;353041;72295;2261;23810;34620;0;166965;0;53090;0;0
38;0;0;550788;601148;195405;355382;18;355400;367;1825;18;0;0;0;0;18;355334;18;13;355321;6270;4437;1833;0;349051;106810;0;23123;48371;0;124392;0;46355;0;0
39;0;0;634485;709238;115525;518935;61;518996;399;6156;60;4;0;1;0;55;518801;55;135;518666;4139;2333;1806;0;514527;233474;0;34024;31875;0;130319;0;84835;0;0
40;0;0;456863;498780;180203;276658;27;276685;342;7719;27;1;1;0;0;25;276638;25;13;276625;4914;3470;1444;0;271711;87799;0;16259;25632;0;100078;0;41943;0;0
41;0;0;732615;802417;256060;476544;51;476595;533;6380;50;5;1;0;1;44;476444;44;127;476317;5788;3698;2090;0;470529;168022;0;30744;34807;0;165200;0;71756;0;0
